
R 1100 670   
WE  ./xpm_pictures/neon_wall.xpm
NO ./xpm_pictures/wallW.xpm
SO  ./xpm_pictures/wallW.xpm
EA    ./xpm_pictures/unnamed.xpm
S     ./xpm_pictures/clipart834319.xpm
F 55,55,55
C 40,40,80

        1111111111111111111111111
        1000000000110000000200001
        1011000001110000000200001
        100100N000000000000200001
111111111011000001110000000200001
100000000011000001110111110111111
11110111111111011100000010001
11110111122211111011101010001
11000000110101011100000010001
10002000000000001100000010001
10000000000000001101010110001
110000011101010111110111010111
11110111 1110101 101111010001
11111111 1111111 111111111111